1111111111111111111111111111111111
1E00000000000001000001000000000001
1110010100100000101001000000110101
1010010010101010001001000000010101
1100000P0100100000000000010C000011
1111111111111111111111111111111111