1111111111111111111111111111111111
100000000000000C00000C000000000001
1010010100100000101001000000010101
1110010010101010001001000000010101
1P1000000C00C0000000000000000000C1
1111111111111111111111111111111111