1111111111111111111111111111111111
10000000C000000100000100000P000001
1110010100100000101001000000110101
1010010010101010001001000000010101
11E000000100100000000000010C000011
1111111111111111111111111111111111
